##########
#P       #
#        #
#        #
#        #
#        #
#     E  #
##########
